0 0 0 0 0 0 0 0 0 0 0 0 0 1 1 1 7 0 0 0 0 0 0 0
0 0 0 0 0 0 0 0 0 0 0 1 1 1 1 1 1 0 0 0 0 0 0 0
0 0 0 0 0 0 0 0 0 1 1 1 1 1 1 1 1 1 1 1 1 1 1 1
0 0 0 0 0 0 0 1 1 1 1 1 1 1 1 1 1 1 1 1 1 1 1 1
0 0 0 0 0 1 1 1 1 1 0 0 0 0 8 8 9 1 1 1 1 1 1 1
0 0 0 7 1 1 1 1 1 1 0 0 0 0 8 0 8 1 1 1 1 1 1 1
0 0 0 1 1 1 1 8 8 9 8 8 8 8 8 0 8 1 1 1 1 1 1 1
1 1 1 1 1 1 1 8 0 8 1 1 1 1 1 0 8 1 1 1 1 1 1 1
1 0 0 0 0 0 0 8 0 8 1 1 1 1 1 0 8 1 1 1 1 1 1 1
1 0 0 0 0 0 0 8 0 8 1 1 1 1 1 0 8 1 1 1 1 1 1 1
1 1 1 1 1 1 9 8 0 8 1 1 1 1 1 0 8 1 1 1 1 1 1 1
1 1 1 1 1 1 8 1 0 8 1 1 1 1 1 0 8 1 1 1 1 1 1 1
1 1 1 1 1 1 8 1 0 8 1 1 1 1 1 0 8 1 1 1 1 1 1 1
1 1 1 1 1 1 8 1 0 8 1 1 1 1 1 0 8 1 1 1 1 1 1 1
1 1 1 1 1 1 8 1 0 8 1 1 1 1 1 0 8 1 1 1 1 1 1 1
1 1 1 1 1 1 8 1 0 8 1 1 1 1 1 0 8 1 1 1 1 1 1 1
1 1 1 1 1 1 8 1 0 8 1 1 1 1 1 0 8 1 1 1 1 1 1 1
1 1 1 1 1 1 8 1 0 8 1 1 1 1 1 0 8 1 1 1 1 1 1 1
1 1 1 1 1 1 9 8 8 9 8 8 8 8 8 8 9 1 1 1 1 1 1 1